####################
#.....##.......*...#
#.#.#...*##......###
#.*..###...*..#...##
#.#...#..P...###..*#
#.....###.#*.......#
#..#........#......#
####################