####################
#.....##...##..*...#
###.#...*##...#..###
#.*..###...*...#..##
#.#...#..P...###..*#
#.....#.#.#*...#...#
#..#........#......#
####################