####################
#.....##...##..*...#
###.#...*##...#..#.#
#.*..###...*...#..##
#.#......P...###..*#
#..#..#.#.#*...#...#
#..#..#*....#......#
####################